ASSISTANT	AH S IH S T AH N T
AWAKEN	AH W EY K AH N
BE	B IY
CALIBRATE	K AE L AH B R EY T
EIGHT	EY T
ELEVEN	IH L EH V AH N
ELEVEN(2)	IY L EH V AH N
FIVE	F AY V
FOUR	F AO R
JEW	JH UW
LIGHT	L AY T
NINE	N AY N
ONE	W AH N
ONE(2)	HH W AH N
PAUSE	P AO Z
PLAY	P L EY
RESTART	R IY S T AA R T
SEVEN	S EH V AH N
SHUTDOWN	SH AH T D AW N
SIX	S IH K S
SLEEP	S L IY P
SPEED	S P IY D
TEN	T EH N
TEST	T EH S T
THREE	TH R IY
TOE	T OW
TWELVE	T W EH L V
TWO	T UW
